xxxxxxxxxxxxxxxx
xp-------------x 
x--------------x
x--------------x
x--------------x 
x--------------x 
x--------------x
x--------------x
x--------------x
x--------------x
x--------------x
x--------------x
x--------------x
x--------------x
x--------------x
xxxxxxxxxxxxxxxx
|
xxxxxxxxxxxxxxxx
xiii-----------x 
xiii-----------x
xiii-----------x
x--------------x 
x--------------x 
x--------------x
x--------------x
x--------------x
x--------------x
x--------------x
x--------------x
x--------------x
x--------------x
x--------------x
xxxxxxxxxxxxxxxx
|
xxxxxxxxxxxxxxxx
x-----------iiix 
x-----------iiix
x-----------iiix
x--------------x 
x--------------x 
x--------------x
x--------------x
x--iii---------x
x--iii---------x
x--iii---------x
x--------------x
x--------------x
x--------------x
x--------------x
xxxxxxxxxxxxxxxx
|
xxxxxxxxxxxxxxxx
x--------------x 
x--------------x
x--------------x
x--------------x 
x--------------x 
x--------------x
x--------------x
x--------iii---x
x--------iii---x
x--------iii---x
x--------------x
x--------------x
x--------------x
x--------------x
xxxxxxxxxxxxxxxx
|
xxxxxxxxxxxxxxxx
x--------------x 
x--------------x
x--------------x
x--------------x 
x--------------x 
x--------------x
x--------------x
x--------------x
x--------------x
x--------------x
x--------------x
x--------------x
x--------------x
x--------------x
xxxxxxxxxxxxxxxx
|
xxxxxxxxxxxxxxxx
x--------------x 
x--------------x
x--------------x
x--------------x 
x--------------x 
x--------------x
x--------------x
x--------------x
x--------------x
x--------------x
x---iii--------x
x---iii--------x
x--------------x
x--------------x
xxxxxxxxxxxxxxxx
|
xxxxxxxxxxxxxxxx
x--------------x 
x--------------x
x--------------x
x--------------x 
x--------------x 
x--------------x
x--------------x
x--------------x
x--------------x
x--------------x
x--------------x
x--------------x
x--------------x
x--------------x
xxxxxxxxxxxxxxxx
|
xxxxxxxxxxxxxxxx
x--------------x 
x--------------x
x--------------x
x--------------x 
x--------------x 
x--------------x
x--------------x
x--------------x
x--------------x
x--------------x
x--------------x
x--------------x
x--------------x
x--------------x
xxxxxxxxxxxxxxxx
|					
xxxxxxxxxxxxxxxx
x--------------x 
x--------------x
x--------------x
x--------------x 
x--------------x 
x--------------x
x--------------x
x--------------x
x--------------x
x--------------x
x--------------x
x--------------x
x--------------x
xiiiiiiiiiiiiiix
xxxxxxxxxxxxxxxx
|					
xxxxxxxxxxxxxxxx
x--------------x 
x--------------x
x--------------x
x--------------x 
x--------------x 
x--------------x
x--------------x
x--------------x
x--------------x
x--------------x
x--------------x
x--------------x
x--------------x
x--------------x
xxxxxxxxxxxxxxxx
|
xxxxxxxxxxxxxxxx
x--------------x 
x--------------x
x--------------x
x--------------x 
x--------------x 
x--------------x
x--------------x
x--------------x
x--------------x
x--------------x
x--------------x
x--------------x
x--------------x
x--------------x
xxxxxxxxxxxxxxxx
|
xxxxxxxxxxxxxxxx
x--------------x 
x--------------x
x--------------x
x--------------x 
x--------------x 
x--------------x
x--------------x
x--------------x
x--------------x
x--------------x
x--------------x
x--------------x
x--------------x
x--------------x
xxxxxxxxxxxxxxxx
|
xxxxxxxxxxxxxxxx
x-----iii------x 
x--------------x
x--------------x
x--------------x 
x--------------x 
x--------------x
x--------------x
x--------------x
x--------------x
x--------------x
x--------------x
x--------------x
x--------------x
x--------------x
xxxxxxxxxxxxxxxx
|
xxxxxxxxxxxxxxxx
x--------------x 
x--------------x
x--------------x
x--------------x 
x--------------x 
x--------------x
x--------------x
x--------------x
x--------------x
x--------------x
x--------------x
x--------------x
x--------------x
x--------------x
xxxxxxxxxxxxxxxx
|
xxxxxxxxxxxxxxxx
xxxxxxxxxxxxxxxx
xxxxxxxxxxxxxxxx
xxxxxxxxxxxxxxxx
xxxxxxxxxxxxxxxx
xxxxxxxxxxxxxxxx
xxxxxx---xxxxxxx
xxxxxx---xxxxxxx
xxxxxx---xxxxxxx
xxxxxxxxxxxxxxxx
xxxxxxxxxxxxxxxx
xxxxxxxxxxxxxxxx
xxxxxxxxxxxxxxxx
xxxxxxxxxxxxxxxx
xxxxxxxxxxxxxxxx
xxxxxxxxxxxxxxxx