xxxxxxxxxxxxxxxxxxx
x-------e---e-----x
x---xxxx-----xx---x
x----e------e--e--x 
x--e------e--x----x
x----xx--e---x----x
x------e--p---e---x
x-------e---e-----x
x---xxxx-----xx---x
x----e------e--e--x 
xxxxxxxxxxxxxxxxxxx

