xxxxxxxxxxxxxxxx
xp------^------x 
x--------------x
x--------------x
x--------------x 
x--------------x 
x--------------x
x^------------^x
x--------------x
x--------------x
x--------------x
x--------------x
x--------------x
x--------------x
x------^-------x
xxxxxxxxxxxxxxxx
|
xxxxxxxxxxxxxxxx
xiii-----------x 
xi*i-----------x
xiii-----------x
x--------------x 
x--------------x 
x--------------x
x--------------x
x--------------x
x--------------x
x--------------x
x--------------x
x--------------x
x--------------x
x--------------x
xxxxxxxxxxxxxxxx
|
xxxxxxxxxxxxxxxx
x-----------iicx 
x-----------i*ix
x-----------iiix
x--------------x 
x--------------x 
x--------------x
x--------------x
x--------------x
x--------------x
x--------------x
x--------------x
x--------------x
x--------------x
x--------------x
xxxxxxxxxxxxxxxx
|
xxxxxxxxxxxxxxxx
xc-------------x 
x--------------x
x--------------x
x--------------x 
x--------------x 
x--------------x
x--------------x
x--------------x
x--------------x
x--------------x
x--------------x
x------------iix
x------------iix
x------------i*x
xxxxxxxxxxxxxxxx
|
xxxxxxxxxxxxxxxx
x--------------x 
x--------------x
x--------------x
x--------------x 
x--------------x 
x--------------x
x--------------x
x--------------x
x--------------x
x--------------x
x--------------x
x--------------x
x--------------x
x--------------x
xxxxxxxxxxxxxxxx
|
xxxxxxxxxxxxxxxx
x------ici-----x 
x--------------x
x--------------x
x--------------x 
x--------------x 
x--------------x
x--------------x
x--------------x
x--------------x
x--------------x
x---i*i--------x
x---iii--------x
x--------------x
x--------------x
xxxxxxxxxxxxxxxx
|
xxxxxxxxxxxxxxxx
x--------------x 
x--------------x
x--------------x
x--------------x 
x--------------x 
x-----iii------x
x-----ici------x
x-----iii------x
x--------------x
x--------------x
x--------------x
x--------------x
x--------------x
x--------------x
xxxxxxxxxxxxxxxx
|
xxxxxxxxxxxxxxxx
x--------------x 
x--------------x
x--------------x
x--------------x 
x--------------x 
x-----iii------x
x-----ici------x
x-----iii------x
x--------------x
x--------------x
x--------------x
x--------------x
x--------------x
x--------------x
xxxxxxxxxxxxxxxx
|					
xxxxxxxxxxxxxxxx
x--------------x 
x--------------x
x--------------x
x--------------x 
x--------------x 
x--------------x
x*i------------x
xii------------x
x--------------x
x--------------x
x--------------x
x--------------x
x--------------x
xiii*iiciii*iiix
xxxxxxxxxxxxxxxx
|					
xxxxxxxxxxxxxxxx
xiiiii---------x 
xiiiii---------x
xiiiii---------x
xiiiii---------x 
xiiiii---------x 
xiiiii---------x
xiiiii---------x
xiiiii---------x
xiiiii---------x
xiiiii---------x
xiiiii---------x
xiiiii---------x
xiiiii---------x
xiiiii---------x
xxxxxxxxxxxxxxxx
|
xxxxxxxxxxxxxxxx
x--------------x 
x--------------x
x^-ici---------x
x--------------x 
x--------------x 
x--------------x
x-------------^x
x--------------x
x--------------x
x^-ici---------x
x--------------x
x--------------x
x--------------x
x--------------x
xxxxxxxxxxxxxxxx
|
xxxxxxxxxxxxxxxx
x--------------x 
x--------------x
x--------------x
x--------------x 
x--------------x 
x--------------x
x--------------x
x--------------x
x--------------x
x--------------x
x--------------x
x--------------x
x--------------x
x--------------x
xxxxxxxxxxxxxxxx
|
xxxxxxxxxxxxxxxx
x-----i*i------x 
x--------------x
x--------------x
x--------------x 
x--------------x 
x--------------x
x------------iix
x------------*ix
x--------------x
x--------------x
x--------------x
x--------------x
x-----iii------x
x-----ici------x
xxxxxxxxxxxxxxxx
|
xxxxxxxxxxxxxxxx
x--------------x 
x--------------x
x--------------x
x--------------x 
x--------------x 
x--------------x
x--------------x
x--------------x
x--------------x
x--------------x
x--------------x
x--------------x
x--------------x
x--------------x
xxxxxxxxxxxxxxxx
|
xxxxxxxxxxxxxxxx
xiiiiiiiiiiiiiix
xiiiiiiiiiiiiiix
xiiiiii*iiiiiiix
xiiiiiiiiiiiiiix
xiiiiiiiiiiiiiix
xiiiii---iiiiiix
xii*ii-g-ii*iiix
xiiiii---iiiiiix
xiiiiiiiiiiiiiix
xiiiiiiiiiiiiiix
xiiiiii*iiiiiiix
xiiiiiiiiiiiiiix
xiiiiiiiiiiiiiix
xiiiiiiiiiiiiiix
xxxxxxxxxxxxxxxx