xxxxxxxxxxxxxxxx
xp-------------x 
x--------------x
x--------------x
x--------------x 
x--------------x 
x--------------x
x--------------x
x--------------x
x--------------x
x--------------x
x--------------x
x--------------x
x--------------x
x--------------x
xxxxxxxxxxxxxxxx
|
xxxxxxxxxxxxxxxx
xiii-----------x 
xiii-----------x
xiii-----------x
x--------------x 
x--------------x 
x--------------x
x--------------x
x--------------x
x--------------x
x--------------x
x--------------x
x--------------x
x--------------x
x--------------x
xxxxxxxxxxxxxxxx
|
xxxxxxxxxxxxxxxx
x-----------iiix 
x-----------iiix
x-----------iiix
x--------------x 
x--------------x 
x--------------x
x--------------x
x--iii---------x
x--iii---------x
x--iii---------x
x--------------x
x--------------x
x--------------x
x--------------x
xxxxxxxxxxxxxxxx
|
xxxxxxxxxxxxxxxx
x--------------x 
x--------------x
x--------------x
x--------------x 
x--------------x 
x--------------x
x--------------x
x--------xxx---x
x--------xxx---x
x--------xxx---x
x--------------x
x--------------x
x--------------x
x--------------x
xxxxxxxxxxxxxxxx
|
xxxxxxxxxxxxxxxx
x--------------x 
x--------------x
x--------------x
x--------------x 
x--------------x 
x--------------x
x--------------x
x--------------x
x--------------x
x--------------x
x--------------x
x--------------x
x--------------x
x--------------x
xxxxxxxxxxxxxxxx
|
xxxxxxxxxxxxxxxx
x--------------x 
x--------------x
x--------------x
x--------------x 
x--------------x 
x--------------x
x--------------x
x--------------x
x--------------x
x--------------x
x---xxx--------x
x---xxx--------x
x--------------x
x--------------x
xxxxxxxxxxxxxxxx
|
xxxxxxxxxxxxxxxx
x--------------x 
x--------------x
x--------------x
x--------------x 
x--------------x 
x--------------x
x--------------x
x--------------x
x--------------x
x--------------x
x--------------x
x--------------x
x--------------x
x--------------x
xxxxxxxxxxxxxxxx