xxxxxxxxxxxxxxxx
x--------------x 
x--------------x
x--------------x
x--------------x 
x--------------x 
x------p-------x
x--------------x
x--------------x
x--------------x
x--------------x
x--------------x
x--------------x
x--------------x
x--------------x
xxxxxxxxxxxxxxxx
|
xxxxxxxxxxxxxxxx
xiii-----------x 
xi*i-----------x
xiii-----------x
x--------------x 
x--------------x 
x-----iii------x
x-----i*i------x
x-----iii------x
x--------------x
x--------------x
x--------------x
x--------------x
x--------------x
x--------------x
xxxxxxxxxxxxxxxx
|
xxxxxxxxxxxxxxxx
x-----------iiix 
x-----------i*ix
x-----------iiix
x--------------x 
x--------------x 
x--------------x
x--------------x
x--iii---------x
x--i*i---------x
x--iii---------x
x--------------x
x--------------x
x--------------x
x--------------x
xxxxxxxxxxxxxxxx
|
xxxxxxxxxxxxxxxx
x--------------x 
x--------------x
x--------------x
x--------------x 
x--------------x 
x--------------x
x--------------x
x--------iii---x
x--------i*i---x
x--------iii---x
x--------------x
x--------------x
x--------------x
x--------------x
xxxxxxxxxxxxxxxx
|
xxxxxxxxxxxxxxxx
x--------------x 
x--------------x
x--------------x
x--------------x 
x--------------x 
x--------------x
x--------------x
x--------------x
x--------------x
x--------------x
x--------------x
x--------------x
x--------------x
x--------------x
xxxxxxxxxxxxxxxx
|
xxxxxxxxxxxxxxxx
x--------------x 
x--------------x
x--------------x
x--------------x 
x--------------x 
x--------------x
x--------------x
x--------------x
x--------------x
x--------------x
x---i*i--------x
x---iii--------x
x--------------x
x--------------x
xxxxxxxxxxxxxxxx
|
xxxxxxxxxxxxxxxx
x--------------x 
x--------------x
x--------------x
x--------------x 
x--------------x 
x--------------x
x--------------x
x--------------x
x--------------x
x--------------x
x--------------x
x--------------x
x--------------x
x--------------x
xxxxxxxxxxxxxxxx
|
xxxxxxxxxxxxxxxx
x--------------x 
x--------------x
x--------------x
x--------------x 
x--------------x 
x--------------x
x--------------x
x--------------x
x--------------x
x--------------x
x--------------x
x--------------x
x--------------x
x--------------x
xxxxxxxxxxxxxxxx
|					
xxxxxxxxxxxxxxxx
x--------------x 
x--------------x
x--------------x
x--------------x 
x--------------x 
x--------------x
x--------------x
x--------------x
x--------------x
x--------------x
x--------------x
x--------------x
x--------------x
xiii*iiiiii*iiix
xxxxxxxxxxxxxxxx
|					
xxxxxxxxxxxxxxxx
x--------------x 
x--------------x
x--------------x
x--------------x 
x--------------x 
x--------------x
x--------------x
x--------------x
x--------------x
x--------------x
x--------------x
x--------------x
x--------------x
x--------------x
xxxxxxxxxxxxxxxx
|
xxxxxxxxxxxxxxxx
x--------------x 
x--------------x
x--------------x
x--------------x 
x--------------x 
x--------------x
x--------------x
x--------------x
x--------------x
x--------------x
x--------------x
x--------------x
x--------------x
x--------------x
xxxxxxxxxxxxxxxx
|
xxxxxxxxxxxxxxxx
x--------------x 
x--------------x
x--------------x
x--------------x 
x--------------x 
x--------------x
x--------------x
x--------------x
x--------------x
x--------------x
x--------------x
x--------------x
x--------------x
x--------------x
xxxxxxxxxxxxxxxx
|
xxxxxxxxxxxxxxxx
x-----i*i------x 
x--------------x
x--------------x
x--------------x 
x--------------x 
x--------------x
x--------------x
x--------------x
x--------------x
x--------------x
x--------------x
x--------------x
x--------------x
x--------------x
xxxxxxxxxxxxxxxx
|
xxxxxxxxxxxxxxxx
x--------------x 
x--------------x
x--------------x
x--------------x 
x--------------x 
x--------------x
x--------------x
x--------------x
x--------------x
x--------------x
x--------------x
x--------------x
x--------------x
x--------------x
xxxxxxxxxxxxxxxx
|
xxxxxxxxxxxxxxxx
xiiiiiiiiiiiiiix
xiiiiiiiiiiiiiix
xiiiiii*iiiiiiix
xiiiiiiiiiiiiiix
xiiiiiiiiiiiiiix
xiiiiigggiiiiiix
xii*iigggii*iiix
xiiiiigggiiiiiix
xiiiiiiiiiiiiiix
xiiiiiiiiiiiiiix
xiiiiii*iiiiiiix
xiiiiiiiiiiiiiix
xiiiiiiiiiiiiiix
xiiiiiiiiiiiiiix
xxxxxxxxxxxxxxxx