xxxxxxxxxxxxxxxx
x--p-----------x 
x--------------x
x--------------x
x--------------x 
x--------------x 
x--------------x
x--------------x
x--------------x
x--------------x
x--------------x
x--------------x
x--------------x
x--------------x
x--------------x
xxxxxxxxxxxxxxxx
|
xxxxxxxxxxxxxxxx
xxxx-----------x 
xxxx-----------x
xxxx-----------x
x--------------x 
x--------------x 
x--------------x
x--------------x
x--------------x
x--------------x
x--------------x
x--------------x
x--------------x
x--------------x
x--------------x
xxxxxxxxxxxxxxxx
|
xxxxxxxxxxxxxxxx
x-----------xxxx 
x-----------xxxx
x-----------xxxx
x--------------x 
x--------------x 
x--------------x
x--------------x
x--xxx---------x
x--xxx---------x
x--xxx---------x
x--------------x
x--------------x
x--------------x
x--------------x
xxxxxxxxxxxxxxxx
|
xxxxxxxxxxxxxxxx
x--------------x 
x--------------x
x--------------x
x--------------x 
x--------------x 
x--------------x
x--------------x
x--------xxx---x
x--------xxx---x
x--------xxx---x
x--------------x
x--------------x
x--------------x
x--------------x
xxxxxxxxxxxxxxxx
